##########
#       o#
#  @@   o#
#    A   #
##########
