######
# A  #
# @o #
# @o #
######
